#########################################
#       #           #                 # #
# ##### # ####### # # ### ########### # #
#     # # #   #   # # #   #         #   #
####### # ### # ### # ##### ####### #####
#   #   #   # # #     #   # #   #   #   #
# # # ##### # # # ##### # # ### # ### # #
# #   #   #   # # #     #   #   # #   # #
# ##### # ### # ### ######### ### # ### #
#       #     #   #       #   #   # #   #
############### # ####### # # # ### # ###
#     #       # #     #   # # #   # # # #
# ### # ##### ### # # # ### # ### # # # #
# #     #   #   # # # # #   #   # # #   #
# ####### ##### ### # # # ##### # # ### #
#     #   #         # # #   #   #   #   #
# ### ### # ######### # ### ######### ###
# # #   #   #   # #   #   #     #   #   #
# # ### # ### # # # ##### ##### # # ### #
#     # #   # # #   #     #     # #     #
##### # ### # # ##### ##### ##### #######
#   # # #   # #     # #           #     #
# ### # ##### ##### ### ############# # #
# #   #         #   #   #             # #
# # ############# ### ######### # #######
# # #   # #     #   # #       # # #     #
# # # # # # ### ### # # ##### # ### ### #
#   # #   # #       # # #   #   #     # #
# ### ### # ####### # # # ### ### ##### #
# #   #   # #   #   # # #     #   #     #
# # ### ### # # ### # # ### ### ### #####
#   #   #   # #   # # #   #   # # #     #
##### ### ### ### ### # # ##### # ##### #
#   #   #     # #   # # # #           # #
### ### ####### ### # ### # ####### ### #
#   #   #       #   #   #   #   #o  #   #
# ### ######### # # ### ##### # ##### # #
# #   #       # # # #   #   # #   #   # #
# # ### ##### # # ### ### # # ### # ### #
#       #       #         #   #     #   #
#########################################